WWWWWWWWWWWWWWWWWWWWWWWWWWWWWWWWWWWWWWWWWWWWWWWWWWWWWWWWWWWWWWWWWWWWWWWWWWWWWWW
Wc zzzzzzzzzzzzzzzzzzzzzzzzzzzzzzzzzzzzzzzzzzzzzzzzzzzzzzzzzzzzzzzzzzzzzzzzz  W
W WzWzWzWzWzWzWzWzWzWzWzWzWzWzWzWzWzWzWzWzWzWzWzWzWzWzWzWzWzWzWzWzWzWzWzWzWzW W
WzzzzzzzzzzzzzzzzzzzzzzzzzzzzzzzzzzzzzzzzzzzzzzzzzzzzzzzzzzzzzzzzzzzzzzzzzzzzzW
WzWzWzWzWzWzWzWzWzWzWzWzWzWzWzWzWzWzWzWzWzWzWzWzWzWzWzWzWzWzWzWzWzWzWzWzWzWzWzW
WzzzzzzzzzzzzzzzzzzzzzzzzzzzzzzzzzzzzzzzzzzzzzzzzzzzzzzzzzzzzzzzzzzzzzzzzzzzzzW
WzWzWzWzWzWzWzWzWzWzWzWzWzWzWzWzWzWzWzWzWzWzWzWzWzWzWzWzWzWzWzWzWzWzWzWzWzWzWzW
WzzzzzzzzzzzzzzzzzzzzzzzzzzzzzzzzzzzzzzzzzzzzzzzzzzzzzzzzzzzzzzzzzzzzzzzzzzzzzW
WzWzWzWzWzWzWzWzWzWzWzWzWzWzWzWzWzWzWzWzWzWzWzWzWzWzWzWzWzWzWzWzWzWzWzWzWzWzWzW
WzzzzzzzzzzzzzzzzzzzzzzzzzzzzzzzzzzzzzzzzzzzzzzzzzzzzzzzzzzzzzzzzzzzzzzzzzzzzzW
WzWzWzWzWzWzWzWzWzWzWzWzWzWzWzWzWzWzWzWzWzWzWzWzWzWzWzWzWzWzWzWzWzWzWzWzWzWzWzW
WzzzzzzzzzzzzzzzzzzzzzzzzzzzzzzzzzzzzzzzzzzzzzzzzzzzzzzzzzzzzzzzzzzzzzzzzzzzzzW
WzWzWzWzWzWzWzWzWzWzWzWzWzWzWzWzWzWzWzWzWzWzWzWzWzWzWzWzWzWzWzWzWzWzWzWzWzWzWzW
WzzzzzzzzzzzzzzzzzzzzzzzzzzzzzzzzzzzzzzzzzzzzzzzzzzzzzzzzzzzzzzzzzzzzzzzzzzzzzW
WzWzWzWzWzWzWzWzWzWzWzWzWzWzWzWzWzWzWzWzWzWzWzWzWzWzWzWzWzWzWzWzWzWzWzWzWzWzWzW
WzzzzzzzzzzzzzzzzzzzzzzzzzzzzzzzzzzzzzzzzzzzzzzzzzzzzzzzzzzzzzzzzzzzzzzzzzzzzzW
WzWzWzWzWzWzWzWzWzWzWzWzWzWzWzWzWzWzWzWzWzWzWzWzWzWzWzWzWzWzWzWzWzWzWzWzWzWzWzW
WzzzzzzzzzzzzzzzzzzzzzzzzzzzzzzzzzzzzzzzzzzzzzzzzzzzzzzzzzzzzzzzzzzzzzzzzzzzzzW
WzWzWzWzWzWzWzWzWzWzWzWzWzWzWzWzWzWzWzWzWzWzWzWzWzWzWzWzWzWzWzWzWzWzWzWzWzWzWzW
WzzzzzzzzzzzzzzzzzzzzzzzzzzzzzzzzzzzzzzzzzzzzzzzzzzzzzzzzzzzzzzzzzzzzzzzzzzzzzW
W WzWzWzWzWzWzWzWzWzWzWzWzWzWzWzWzWzWzWzWzWzWzWzWzWzWzWzWzWzWzWzWzWzWzWzWzWzW W
W  zzzzzzzzzzzzzzzzzzzzzzzzzzzzzzzzzzzzzzzzzzzzzzzzzzzzzzzzzzzzzzzzzzzzzzzzz eW
WWWWWWWWWWWWWWWWWWWWWWWWWWWWWWWWWWWWWWWWWWWWWWWWWWWWWWWWWWWWWWWWWWWWWWWWWWWWWWW
