WWWWWWWWWWWWWWWWWWWWWWWWWWWWWWWWWWWWWWWWWWWWWWWWWWWWWWWWWWWWWWWWWWWWWWWWWWWWWWW
Wc zzzzzzzzzzzzzzzzzzzzzzzzzzzzzzzzzzzzzzzzzzzzzzzzzzzzzzzzzzzzzzzzzzzzzzzzz  W
W WzWzWzWzWzWzWzWzWzWzWzWzWzWzWzWzWzWzWzWzWzWzWzWzWzWzWzWzWzWzWzWzWzWzWzWzWzW W
WzWzWzWzWzWzWzWzWzWzWzWzWzWzWzWzWzWzWzWzWzWzWzWzWzWzWzWzWzWzWzWzWzWzWzWzWzWzWzW
WzWzWzWzWzWzWzWzWzWzWzWzWzWzWzWzWzWzWzWzWzWzWzWzWzWzWzWzWzWzWzWzWzWzWzWzWzWzWzW
WzWzWzWzWzWzWzWzWzWzWzWzWzWzWzWzWzWzWzWzWzWzWzWzWzWzWzWzWzWzWzWzWzWzWzWzWzWzWzW
WzWzWzWzWzWzWzWzWzWzWzWzWzWzWzWzWzWzWzWzWzWzWzWzWzWzWzWzWzWzWzWzWzWzWzWzWzWzWzW
WzWzWzWzWzWzWzWzWzWzWzWzWzWzWzWzWzWzWzWzWzWzWzWzWzWzWzWzWzWzWzWzWzWzWzWzWzWzWzW
WzWzWzWzWzWzWzWzWzWzWzWzWzWzWzWzWzWzWzWzWzWzWzWzWzWzWzWzWzWzWzWzWzWzWzWzWzWzWzW
WzWzWzWzWzWzWzWzWzWzWzWzWzWzWzWzWzWzWzWzWzWzWzWzWzWzWzWzWzWzWzWzWzWzWzWzWzWzWzW
WzWzWzWzWzWzWzWzWzWzWzWzWzWzWzWzWzWzWzWzWzWzWzWzWzWzWzWzWzWzWzWzWzWzWzWzWzWzWzW
WzWzWzWzWzWzWzWzWzWzWzWzWzWzWzWzWzWzWzWzWzWzWzWzWzWzWzWzWzWzWzWzWzWzWzWzWzWzWzW
WzWzWzWzWzWzWzWzWzWzWzWzWzWzWzWzWzWzWzWzWzWzWzWzWzWzWzWzWzWzWzWzWzWzWzWzWzWzWzW
WzWzWzWzWzWzWzWzWzWzWzWzWzWzWzWzWzWzWzWzWzWzWzWzWzWzWzWzWzWzWzWzWzWzWzWzWzWzWzW
WzWzWzWzWzWzWzWzWzWzWzWzWzWzWzWzWzWzWzWzWzWzWzWzWzWzWzWzWzWzWzWzWzWzWzWzWzWzWzW
WzWzWzWzWzWzWzWzWzWzWzWzWzWzWzWzWzWzWzWzWzWzWzWzWzWzWzWzWzWzWzWzWzWzWzWzWzWzWzW
WzWzWzWzWzWzWzWzWzWzWzWzWzWzWzWzWzWzWzWzWzWzWzWzWzWzWzWzWzWzWzWzWzWzWzWzWzWzWzW
WzWzWzWzWzWzWzWzWzWzWzWzWzWzWzWzWzWzWzWzWzWzWzWzWzWzWzWzWzWzWzWzWzWzWzWzWzWzWzW
WzWzWzWzWzWzWzWzWzWzWzWzWzWzWzWzWzWzWzWzWzWzWzWzWzWzWzWzWzWzWzWzWzWzWzWzWzWzWzW
WzWzWzWzWzWzWzWzWzWzWzWzWzWzWzWzWzWzWzWzWzWzWzWzWzWzWzWzWzWzWzWzWzWzWzWzWzWzWzW
W WzWzWzWzWzWzWzWzWzWzWzWzWzWzWzWzWzWzWzWzWzWzWzWzWzWzWzWzWzWzWzWzWzWzWzWzWzW W
W  zzzzzzzzzzzzzzzzzzzzzzzzzzzzzzzzzzzzzzzzzzzzzzzzzzzzzzzzzzzzzzzzzzzzzzzzz eW
WWWWWWWWWWWWWWWWWWWWWWWWWWWWWWWWWWWWWWWWWWWWWWWWWWWWWWWWWWWWWWWWWWWWWWWWWWWWWWW
